TILEMAP
22 20 							-- Size of tile map in tiles
24 24 							-- Tile size & block size
images/babaisyou.png 	-- Tilesheet
64 16								-- Number of tiles in tilesheet
6 17								-- Player initial pos in tiles
224 804 804 804 804 804 804 804 804 804 804 804 804 804 804 804 804 804 804 804 804 804 
804 608 386 391 0 0 0 0 0 0 0 0 0 0 0 0 0 0 0 0 0 804 
804 410 386 392 0 0 0 0 0 0 0 0 0 0 0 0 0 0 0 0 0 804 
804 0 0 0 0 0 0 0 0 0 0 0 0 0 0 0 0 0 0 0 0 804 
804 0 0 0 0 0 0 0 0 0 0 0 0 0 0 0 0 0 0 0 0 804 
804 0 0 0 0 0 0 0 0 0 0 0 0 0 0 0 0 0 0 0 0 804 
804 0 0 0 0 0 0 0 0 0 0 0 420 420 420 420 420 420 420 420 0 804 
804 0 0 0 0 0 0 0 0 0 0 0 420 0 0 0 0 0 0 420 0 804 
804 0 396 386 388 0 0 0 0 0 0 0 420 0 397 0 0 0 0 420 0 804 
804 0 0 0 0 0 0 0 0 0 0 0 420 0 386 0 0 0 0 420 0 804 
804 0 0 0 0 0 0 0 0 0 0 0 420 0 387 0 0 0 0 420 0 804 
804 0 0 0 0 0 0 0 0 0 0 0 420 0 0 0 0 599 0 420 0 804 
804 0 0 0 0 420 0 420 0 0 0 0 420 0 0 0 0 0 0 420 0 804 
804 0 0 0 0 420 605 420 0 0 0 0 420 420 420 420 420 420 420 420 0 804 
804 0 0 420 420 420 605 420 420 420 0 0 0 0 0 0 0 0 0 0 0 804 
804 0 0 420 0 0 605 0 0 420 0 0 0 0 0 0 0 0 0 0 0 804 
804 0 0 420 0 0 0 0 0 420 0 0 0 0 0 0 0 0 0 0 0 804 
804 0 0 420 0 0 0 0 0 420 0 0 0 0 0 0 0 0 0 0 0 804 
804 0 0 420 0 0 0 0 0 420 0 0 0 0 0 0 0 0 0 0 0 804 
804 804 804 804 804 804 804 804 804 804 804 804 804 804 804 804 804 804 804 804 804 804 