TILEMAP
22 20 							-- Size of tile map in tiles
24 24 							-- Tile size & block size
images/babaisyou.png 	-- Tilesheet
64 16								-- Number of tiles in tilesheet
4 8								-- Player initial pos in tiles
486 486 486 486 486 486 486 486 486 486 486 486 486 486 486 486 486 486 486 486 486 486 
486 608 386 391 204 200 199 0 0 204 208 207 0 0 0 195 0 0 612 386 389 486 
486 206 206 198 199 0 0 0 202 208 208 199 0 193 0 0 0 0 0 0 0 486 
486 208 199 0 0 0 0 0 204 208 207 0 201 0 0 0 405 405 405 0 0 486 
486 199 0 0 0 0 0 0 204 208 208 206 208 205 0 405 405 0 405 405 0 486 
486 0 0 0 0 0 0 0 204 208 200 200 200 207 0 405 0 599 0 405 0 486 
486 0 58 54 54 54 61 0 204 199 0 0 0 196 205 405 405 0 405 405 0 486 
486 0 59 0 0 0 59 0 203 0 0 0 0 0 203 0 405 405 405 0 0 486 
486 0 59 0 0 0 59 0 203 0 0 399 0 0 204 205 0 0 0 0 0 486 
486 0 59 0 0 0 59 0 203 0 0 0 0 0 204 208 205 0 0 0 0 486 
486 0 52 53 0 50 55 0 204 205 0 0 0 202 208 208 207 0 201 0 0 486 
486 0 0 0 0 0 0 0 196 200 206 206 206 208 208 208 207 0 196 197 0 486 
486 0 0 0 0 0 0 0 0 0 196 200 208 208 208 208 207 0 0 0 0 486 
486 0 0 0 0 50 54 54 53 0 0 0 196 208 208 208 207 0 0 0 0 486 			
486 0 57 0 0 410 386 392 385 389 49 0 0 204 208 208 207 0 0 0 0 486 
486 0 52 54 54 54 54 54 53 0 0 0 0 204 208 208 207 0 0 0 0 486 
486 205 0 0 0 0 0 0 0 0 0 0 0 196 208 208 208 205 0 0 0 486 
486 208 205 0 0 0 0 0 0 0 0 0 0 0 196 208 208 208 197 0 0 486 
486 208 208 206 206 205 0 201 0 0 201 0 0 0 0 204 208 207 399 386 390 486 
486 486 486 486 486 486 486 486 486 486 486 486 486 486 486 486 486 486 486 486 486 486 