TILEMAP
22 20 							-- Size of tile map in tiles
24 24 							-- Tile size & block size
images/babaisyou.png 	-- Tilesheet
64 16								-- Number of tiles in tilesheet
6 11								-- Player initial pos in tiles
224 486 486 486 486 486 486 486 486 486 486 486 486 486 486 486 486 486 486 486 486 486 
486 486 486 486 486 486 486 486 486 486 486 486 486 486 486 486 486 486 486 486 486 486 
486 486 486 486 486 486 486 486 486 486 486 486 486 486 486 486 486 486 486 486 486 486 
486 486 486 420 420 420 420 420 0 0 0 0 0 59 0 0 0 0 0 486 486 486 
486 486 486 397 386 387 0 420 0 0 0 0 0 59 0 0 0 0 0 486 486 486 
486 486 486 396 386 388 0 420 0 0 0 0 0 59 0 0 0 0 0 486 486 486 
486 486 486 399 386 390 0 0 0 0 0 0 0 59 0 0 0 0 0 486 486 486 
486 486 486 420 420 420 0 0 0 0 0 0 0 59 0 0 605 0 0 486 486 486 
486 486 486 0 0 0 0 0 0 0 0 802 0 59 0 0 0 0 0 486 486 486 
486 486 486 0 0 0 0 0 0 0 0 0 0 59 0 0 0 0 0 486 486 486 
486 486 486 0 0 0 0 0 385 0 0 0 0 59 0 0 605 0 0 486 486 486 
486 486 486 0 391 0 0 0 0 0 0 0 0 59 0 0 0 0 0 486 486 486 
486 486 486 0 0 0 0 0 0 0 0 0 0 59 0 0 0 0 0 486 486 486 
486 486 486 0 0 0 0 0 0 0 0 0 0 59 0 0 0 0 0 486 486 486 
486 486 486 420 420 420 420 420 0 0 0 0 0 59 0 0 0 0 0 486 486 486 
486 486 486 608 386 0 0 420 0 0 0 0 0 59 0 0 0 0 0 486 486 486 
486 486 486 410 386 392 0 420 0 0 0 0 0 59 0 0 0 0 599 486 486 486 
486 486 486 486 486 486 486 486 486 486 486 486 486 486 486 486 486 486 486 486 486 486 
486 486 486 486 486 486 486 486 486 486 486 486 486 486 486 486 486 486 486 486 486 486 
486 486 486 486 486 486 486 486 486 486 486 486 486 486 486 486 486 486 486 486 486 486 