TILEMAP
22 20 							-- Size of tile map in tiles
24 24 							-- Tile size & block size
images/babaisyou.png 	-- Tilesheet
64 16								-- Number of tiles in tilesheet
9 13								-- Player initial pos in tiles
224 804 804 804 804 804 804 804 804 804 804 804 804 804 804 804 804 804 804 804 804 804 
804 0 0 0 0 0 0 0 0 0 0 0 0 0 0 0 0 0 0 0 0 804 
804 0 0 0 0 0 58 54 54 54 54 54 54 54 61 0 0 0 600 0 0 804 
804 0 0 0 0 0 59 0 0 0 0 0 0 0 59 0 0 0 0 0 0 804 
804 0 0 0 0 0 59 0 386 0 0 0 0 0 59 0 0 0 0 0 0 804 
804 0 0 600 0 0 59 0 0 0 0 0 0 0 59 0 0 0 600 0 0 804 
804 0 0 0 0 0 59 0 0 0 0 0 0 0 59 0 0 0 0 0 0 804 
804 0 58 54 54 54 55 0 0 0 0 0 391 0 59 0 0 0 0 0 0 804 
804 0 59 607 607 607 607 0 0 0 0 0 0 0 59 0 0 0 0 0 0 804 
804 0 59 607 608 607 607 0 599 0 0 0 0 0 59 0 600 0 0 0 0 804 
804 0 59 607 607 607 607 0 0 0 0 0 0 0 59 0 0 0 0 0 0 804 
804 0 52 54 54 54 62 54 54 54 54 54 54 54 63 0 0 0 0 0 0 804 
804 0 0 0 0 0 59 0 0 0 0 0 0 0 59 0 0 0 0 0 0 804 
804 0 0 0 0 0 59 0 399 0 0 0 0 0 59 0 0 0 0 0 0 804 
804 0 0 0 0 0 59 0 386 0 0 0 0 0 59 0 0 0 0 600 0 804 
804 604 604 0 0 0 59 0 390 0 0 0 0 0 59 0 0 0 0 0 0 804 
804 410 604 0 0 0 59 0 0 0 0 0 0 0 59 0 0 0 0 0 0 804 
804 386 604 0 0 0 52 54 54 54 54 54 54 54 55 0 600 0 0 0 0 804 
804 392 604 0 0 0 0 0 0 0 0 0 0 0 0 0 0 0 0 0 0 804 
804 804 804 804 804 804 804 804 804 804 804 804 804 804 804 804 804 804 804 804 804 804 