TILEMAP
22 20 							-- Size of tile map in tiles
24 24 							-- Tile size & block size
images/babaisyou.png 	-- Tilesheet
64 16								-- Number of tiles in tilesheet
10 3								-- Player initial pos in tiles
224 804 804 804 804 804 804 804 804 804 804 804 804 804 804 804 804 804 804 804 804 804 
804 410 399 59 0 225 0 0 58 54 54 54 54 54 54 61 0 0 0 0 0 804 
804 386 386 59 0 0 0 0 59 607 607 607 607 607 607 59 0 0 0 0 0 804 
804 392 390 59 0 0 225 0 59 607 0 607 607 605 607 59 0 0 0 0 0 804 
804 54 54 55 0 0 0 402 59 607 607 607 607 607 607 59 0 0 0 0 0 804 
804 0 0 0 228 231 0 386 59 607 607 607 607 605 607 59 240 237 0 0 0 804 
804 0 0 0 0 0 0 389 59 607 607 607 607 607 607 59 0 240 0 0 0 804 
804 0 0 0 0 58 54 54 55 34 38 37 58 54 54 56 54 54 61 0 0 804 
804 225 0 0 0 59 0 0 0 0 0 0 59 0 0 0 0 0 59 225 0 804 
804 0 0 0 0 59 0 0 0 0 0 0 59 0 396 386 388 0 59 0 0 804 
804 0 0 0 0 59 0 0 0 0 0 0 59 0 0 0 0 0 59 0 0 804 
804 0 0 0 0 59 0 0 0 0 0 0 51 0 0 0 0 0 59 0 0 804 
804 0 0 0 0 59 0 0 0 0 49 0 0 0 0 0 0 0 59 0 0 804 
804 0 0 0 0 59 42 46 45 0 0 0 57 0 0 0 0 0 59 0 0 804 
804 0 234 237 0 59 44 48 47 0 0 0 59 0 0 0 0 0 59 0 0 804 
804 0 226 231 0 59 44 48 47 0 0 0 59 0 608 386 391 0 59 0 0 804 
804 0 0 0 0 59 599 40 39 0 0 0 59 0 0 0 0 0 59 0 0 804 
804 0 0 0 0 52 54 54 54 54 54 54 56 54 54 54 54 54 55 0 0 804 
804 0 0 0 0 0 0 0 0 225 0 0 0 0 0 0 0 0 0 0 0 804 
804 804 804 804 804 804 804 804 804 804 804 804 804 804 804 804 804 804 804 804 804 804 