TILEMAP
22 20 							-- Size of tile map in tiles
24 24 							-- Tile size & block size
images/babaisyou.png 	-- Tilesheet
64 16								-- Number of tiles in tilesheet
6 11
486 486 486 486 486 486 486 486 486 486 486 486 486 486 486 486 486 486 486 486 486 486 
486 486 486 486 486 486 486 486 486 486 486 486 486 486 486 486 486 486 486 486 486 486 
486 486 616 386 387 0 0 602 0 0 0 0 0 0 0 0 0 0 0 0 486 486 
486 486 413 386 391 385 802 602 0 0 0 0 410 386 392 0 0 0 0 0 486 486 
486 486 602 602 602 602 602 602 0 0 0 0 0 0 0 0 0 0 0 0 486 486 
486 486 0 0 0 0 0 0 0 0 0 0 0 0 0 0 0 0 0 0 486 486 
486 486 0 0 0 0 0 0 0 0 0 0 0 0 0 0 0 0 0 0 486 486 
486 486 0 0 0 0 0 0 602 602 602 602 602 602 602 0 0 0 0 0 486 486 
486 486 0 0 0 0 0 0 602 602 602 602 602 602 602 0 0 0 0 0 486 486 
486 486 0 0 0 0 0 0 602 602 602 789 602 602 602 0 0 0 0 0 486 486 
486 486 0 0 0 0 0 0 602 602 602 602 602 602 602 0 0 0 0 0 486 486 
486 486 0 0 0 0 0 0 602 602 602 602 602 602 602 0 0 0 0 0 486 486 
486 486 0 0 0 0 0 0 0 0 0 0 0 0 0 0 0 0 0 0 486 486 
486 486 0 0 0 0 0 0 0 0 0 0 0 0 0 0 0 0 0 0 486 486 
486 486 0 0 0 0 0 0 0 0 0 0 0 0 0 0 0 0 0 0 486 486 
486 486 0 0 0 385 0 0 0 0 802 0 0 0 0 0 0 0 0 0 486 486 
486 486 0 0 0 0 0 0 0 0 0 0 0 0 0 0 0 0 0 0 486 486 
486 486 0 0 0 0 0 0 0 0 0 0 0 0 0 0 0 0 0 0 486 486 
486 486 486 486 486 486 486 486 486 486 486 486 486 486 486 486 486 486 486 486 486 486 
486 486 486 486 486 486 486 486 486 486 486 486 486 486 486 486 486 486 486 486 486 486 